fasta.name,chr,region,start,end,width
22005.patch.scaffold.Chr.fa,Chr1,1,14220076,14568988,348912
22005.patch.scaffold.Chr.fa,Chr1,2,15152891,18587527,3434636
22005.patch.scaffold.Chr.fa,Chr2,1,3790857,7897392,4106535
22005.patch.scaffold.Chr.fa,Chr3,1,13419896,18321855,4901959
22005.patch.scaffold.Chr.fa,Chr3,2,20073783,21061813,988030
22005.patch.scaffold.Chr.fa,Chr4,1,7534501,10183496,2648995
22005.patch.scaffold.Chr.fa,Chr4,2,10496163,10772712,276549
22005.patch.scaffold.Chr.fa,Chr5,1,12898830,18676052,5777222
9994.patch.scaffold.Chr.fa,Chr1,1,14394717,18044363,3649646
9994.patch.scaffold.Chr.fa,Chr2,1,4038413,5800781,1762368
9994.patch.scaffold.Chr.fa,Chr3,1,13558952,16481066,2922114
9994.patch.scaffold.Chr.fa,Chr4,1,5134979,7260196,2125217
9994.patch.scaffold.Chr.fa,Chr5,1,12448854,15520332,3071478
Alo-0.ragtag_scaffolds.fa,Chr1,1,14317593,17557150,3239557
Alo-0.ragtag_scaffolds.fa,Chr2,1,4052647,8235319,4182672
Alo-0.ragtag_scaffolds.fa,Chr3,1,13527260,15120409,1593149
Alo-0.ragtag_scaffolds.fa,Chr3,2,15172750,15366486,193736
Alo-0.ragtag_scaffolds.fa,Chr4,1,5321161,6957753,1636592
Alo-0.ragtag_scaffolds.fa,Chr4,2,7727172,8069981,342809
Alo-0.ragtag_scaffolds.fa,Chr5,1,13500523,16870361,3369838
Alo-19.ragtag_scaffolds.fa,Chr1,1,14812564,16794324,1981760
Alo-19.ragtag_scaffolds.fa,Chr2,1,3921023,6704403,2783380
Alo-19.ragtag_scaffolds.fa,Chr3,1,13557069,16802839,3245770
Alo-19.ragtag_scaffolds.fa,Chr4,1,4044838,7572266,3527428
Alo-19.ragtag_scaffolds.fa,Chr4,2,8309011,8886000,576989
Alo-19.ragtag_scaffolds.fa,Chr5,1,13394323,16565627,3171304
ANGE-B-2.ragtag_scaffolds.fa,Chr1,1,14313986,16904885,2590899
ANGE-B-2.ragtag_scaffolds.fa,Chr2,1,3600220,7128598,3528378
ANGE-B-2.ragtag_scaffolds.fa,Chr3,1,13278218,16249787,2971569
ANGE-B-2.ragtag_scaffolds.fa,Chr4,1,4992202,7789689,2797487
ANGE-B-2.ragtag_scaffolds.fa,Chr5,1,12489619,15356901,2867282
6137.ragtag_scaffolds.fa,Chr1,1,14401501,17716454,3314953
6137.ragtag_scaffolds.fa,Chr2,1,3772501,6667470,2894969
6137.ragtag_scaffolds.fa,Chr3,1,13437041,16273418,2836377
6137.ragtag_scaffolds.fa,Chr4,1,4804061,7754900,2950839
6137.ragtag_scaffolds.fa,Chr5,1,12434170,15734987,3300817
6923.scaffolds.bionano.final.fa,Chr1,1,14534286,15668278,1133992
6923.scaffolds.bionano.final.fa,Chr2,1,3997544,5720890,1723346
6923.scaffolds.bionano.final.fa,Chr3,1,13918580,18116465,4197885
6923.scaffolds.bionano.final.fa,Chr4,1,4314550,6204438,1889888
6923.scaffolds.bionano.final.fa,Chr5,1,12581399,15299444,2718045
7143.scaffolds.bionano.final.fa,Chr1,1,14191501,17639287,3447786
7143.scaffolds.bionano.final.fa,Chr2,1,3531019,5054048,1523029
7143.scaffolds.bionano.final.fa,Chr3,1,14031066,15599957,1568891
7143.scaffolds.bionano.final.fa,Chr4,1,4233804,6285117,2051313
7143.scaffolds.bionano.final.fa,Chr5,1,12864139,16062953,3198814
8285.scaffolds.bionano.final.fa,Chr1,1,14616519,18706896,4090377
8285.scaffolds.bionano.final.fa,Chr2,1,3718960,6395582,2676622
8285.scaffolds.bionano.final.fa,Chr3,1,13245357,13546385,301028
8285.scaffolds.bionano.final.fa,Chr3,2,13883534,15881160,1997626
8285.scaffolds.bionano.final.fa,Chr4,1,4834935,7420866,2585931
8285.scaffolds.bionano.final.fa,Chr4,2,8113096,8632379,519283
8285.scaffolds.bionano.final.fa,Chr5,1,11775123,15247026,3471903
9336.scaffolds.bionano.final.fa,Chr1,1,14475632,17690500,3214868
9336.scaffolds.bionano.final.fa,Chr2,1,3641168,5294999,1653831
9336.scaffolds.bionano.final.fa,Chr2,2,5950896,7218755,1267859
9336.scaffolds.bionano.final.fa,Chr3,1,13985409,16790382,2804973
9336.scaffolds.bionano.final.fa,Chr4,1,5292500,8612727,3320227
9336.scaffolds.bionano.final.fa,Chr5,1,13171189,16133254,2962065
9503.scaffolds.bionano.final.fa,Chr1,1,14350741,16523290,2172549
9503.scaffolds.bionano.final.fa,Chr2,1,3513434,6244192,2730758
9503.scaffolds.bionano.final.fa,Chr3,1,13987788,17542491,3554703
9503.scaffolds.bionano.final.fa,Chr4,1,5361920,7313727,1951807
9503.scaffolds.bionano.final.fa,Chr4,2,8173840,8694884,521044
9503.scaffolds.bionano.final.fa,Chr5,1,12630308,15732646,3102338
9744.scaffolds.bionano.final.fa,Chr1,1,14057396,16372159,2314763
9744.scaffolds.bionano.final.fa,Chr2,1,3837134,4984984,1147850
9744.scaffolds.bionano.final.fa,Chr3,1,13882895,16180867,2297972
9744.scaffolds.bionano.final.fa,Chr4,1,5672199,7960301,2288102
9744.scaffolds.bionano.final.fa,Chr5,1,12602188,16018354,3416166
9762.scaffolds.bionano.final.fa,Chr1,1,14368522,19177117,4808595
9762.scaffolds.bionano.final.fa,Chr2,1,3886059,6293561,2407502
9762.scaffolds.bionano.final.fa,Chr3,1,13429812,16499960,3070148
9762.scaffolds.bionano.final.fa,Chr4,1,5169001,8679902,3510901
9762.scaffolds.bionano.final.fa,Chr5,1,12916457,16338635,3422178
9806.scaffolds.bionano.final.fa,Chr1,1,14660766,18659945,3999179
9806.scaffolds.bionano.final.fa,Chr2,1,3616018,6124415,2508397
9806.scaffolds.bionano.final.fa,Chr3,1,13152050,16349886,3197836
9806.scaffolds.bionano.final.fa,Chr4,1,5079979,8308483,3228504
9806.scaffolds.bionano.final.fa,Chr5,1,12306882,14285436,1978554
9830.scaffolds.bionano.final.fa,Chr1,1,14370692,17059106,2688414
9830.scaffolds.bionano.final.fa,Chr2,1,3781501,5825496,2043995
9830.scaffolds.bionano.final.fa,Chr3,1,13409521,15925499,2515978
9830.scaffolds.bionano.final.fa,Chr4,1,4681501,6575640,1894139
9830.scaffolds.bionano.final.fa,Chr5,1,12599048,14687361,2088313
9847.scaffolds.bionano.final.fa,Chr1,1,14312260,15533898,1221638
9847.scaffolds.bionano.final.fa,Chr2,1,3564888,6551937,2987049
9847.scaffolds.bionano.final.fa,Chr3,1,13417572,17647425,4229853
9847.scaffolds.bionano.final.fa,Chr4,1,4817209,6894688,2077479
9847.scaffolds.bionano.final.fa,Chr5,1,12252001,14714130,2462129
9852.scaffolds.bionano.final.fa,Chr1,1,14522669,17705761,3183092
9852.scaffolds.bionano.final.fa,Chr2,1,3636811,7273047,3636236
9852.scaffolds.bionano.final.fa,Chr3,1,13395569,15275262,1879693
9852.scaffolds.bionano.final.fa,Chr3,2,15557163,15948397,391234
9852.scaffolds.bionano.final.fa,Chr4,1,4299424,8773206,4473782
9852.scaffolds.bionano.final.fa,Chr4,2,9461130,10073966,612836
9852.scaffolds.bionano.final.fa,Chr5,1,12814110,16303500,3489390
9879.scaffolds.bionano.final.fa,Chr1,1,14547318,17959421,3412103
9879.scaffolds.bionano.final.fa,Chr2,1,3873356,8125132,4251776
9879.scaffolds.bionano.final.fa,Chr3,1,13340014,16400880,3060866
9879.scaffolds.bionano.final.fa,Chr4,1,6241653,8219454,1977801
9879.scaffolds.bionano.final.fa,Chr5,1,12871620,16503000,3631380
9883.scaffolds.bionano.final.fa,Chr1,1,14378002,18083413,3705411
9883.scaffolds.bionano.final.fa,Chr2,1,3819215,6908880,3089665
9883.scaffolds.bionano.final.fa,Chr3,1,13587918,15672803,2084885
9883.scaffolds.bionano.final.fa,Chr4,1,5475089,8346532,2871443
9883.scaffolds.bionano.final.fa,Chr4,2,9135991,9580116,444125
9883.scaffolds.bionano.final.fa,Chr5,1,12555033,14345312,1790279
9883.scaffolds.bionano.final.fa,Chr5,2,14830501,15431896,601395
9900.scaffolds.bionano.final.fa,Chr1,1,14327418,17163000,2835582
9900.scaffolds.bionano.final.fa,Chr2,1,3647018,5877484,2230466
9900.scaffolds.bionano.final.fa,Chr3,1,13620018,17031206,3411188
9900.scaffolds.bionano.final.fa,Chr4,1,4448047,6667503,2219456
9900.scaffolds.bionano.final.fa,Chr5,1,12256519,15485891,3229372
AUZE-A-5.ragtag_scaffolds.fa,Chr1,1,14267056,17109742,2842686
AUZE-A-5.ragtag_scaffolds.fa,Chr2,1,4515092,6407529,1892437
AUZE-A-5.ragtag_scaffolds.fa,Chr3,1,13703231,17536855,3833624
AUZE-A-5.ragtag_scaffolds.fa,Chr4,1,5668607,7336312,1667705
AUZE-A-5.ragtag_scaffolds.fa,Chr5,1,12232611,15452671,3220060
BANI-C-1.ragtag_scaffolds.fa,Chr1,1,14224635,17195960,2971325
BANI-C-1.ragtag_scaffolds.fa,Chr2,1,3730503,5772377,2041874
BANI-C-1.ragtag_scaffolds.fa,Chr3,1,14101544,15885358,1783814
BANI-C-1.ragtag_scaffolds.fa,Chr4,1,4842251,6833743,1991492
BANI-C-1.ragtag_scaffolds.fa,Chr5,1,12392566,15602354,3209788
BANI-C-12.ragtag_scaffolds.fa,Chr1,1,14696005,18154083,3458078
BANI-C-12.ragtag_scaffolds.fa,Chr2,1,4171584,6464565,2292981
BANI-C-12.ragtag_scaffolds.fa,Chr3,1,13257554,16225649,2968095
BANI-C-12.ragtag_scaffolds.fa,Chr4,1,6132577,7727416,1594839
BANI-C-12.ragtag_scaffolds.fa,Chr5,1,12603001,16232481,3629480
BARA-C-3.ragtag_scaffolds.fa,Chr1,1,14577982,18216966,3638984
BARA-C-3.ragtag_scaffolds.fa,Chr2,1,4042659,6645744,2603085
BARA-C-3.ragtag_scaffolds.fa,Chr3,1,13745388,16384375,2638987
BARA-C-3.ragtag_scaffolds.fa,Chr4,1,5320574,6869766,1549192
BARA-C-3.ragtag_scaffolds.fa,Chr5,1,13544311,15811438,2267127
BARA-C-5.ragtag_scaffolds.fa,Chr1,1,14298959,17854490,3555531
BARA-C-5.ragtag_scaffolds.fa,Chr2,1,4200001,7203677,3003676
BARA-C-5.ragtag_scaffolds.fa,Chr3,1,13725803,17268457,3542654
BARA-C-5.ragtag_scaffolds.fa,Chr4,1,4305001,5895037,1590036
BARA-C-5.ragtag_scaffolds.fa,Chr5,1,13390501,16682042,3291541
BARC-A-12.ragtag_scaffolds.fa,Chr1,1,14916422,18968292,4051870
BARC-A-12.ragtag_scaffolds.fa,Chr2,1,3405079,6215599,2810520
BARC-A-12.ragtag_scaffolds.fa,Chr3,1,13578289,15334054,1755765
BARC-A-12.ragtag_scaffolds.fa,Chr4,1,5723532,7738569,2015037
BARC-A-12.ragtag_scaffolds.fa,Chr4,2,8529152,9206956,677804
BARC-A-12.ragtag_scaffolds.fa,Chr5,1,12422371,15512854,3090483
BARC-A-17.ragtag_scaffolds.fa,Chr1,1,14916339,18968209,4051870
BARC-A-17.ragtag_scaffolds.fa,Chr2,1,3549237,6362252,2813015
BARC-A-17.ragtag_scaffolds.fa,Chr3,1,13578194,15333966,1755772
BARC-A-17.ragtag_scaffolds.fa,Chr4,1,5748208,7763245,2015037
BARC-A-17.ragtag_scaffolds.fa,Chr4,2,8555417,9233577,678160
BARC-A-17.ragtag_scaffolds.fa,Chr5,1,12425066,15515549,3090483
BELC-C-10.ragtag_scaffolds.fa,Chr1,1,14162563,15989527,1826964
BELC-C-10.ragtag_scaffolds.fa,Chr2,1,3594550,6653936,3059386
BELC-C-10.ragtag_scaffolds.fa,Chr3,1,13369607,15615000,2245393
BELC-C-10.ragtag_scaffolds.fa,Chr4,1,4716098,8449361,3733263
BELC-C-10.ragtag_scaffolds.fa,Chr4,2,9160797,9721175,560378
BELC-C-10.ragtag_scaffolds.fa,Chr5,1,12613973,15485969,2871996
BELC-C-12.ragtag_scaffolds.fa,Chr1,1,14158868,15985476,1826608
BELC-C-12.ragtag_scaffolds.fa,Chr2,1,3726001,6787449,3061448
BELC-C-12.ragtag_scaffolds.fa,Chr3,1,13368735,15614692,2245957
BELC-C-12.ragtag_scaffolds.fa,Chr4,1,4953173,8688371,3735198
BELC-C-12.ragtag_scaffolds.fa,Chr4,2,9399805,9960000,560195
BELC-C-12.ragtag_scaffolds.fa,Chr5,1,12609923,15487500,2877577
BROU-A-10.ragtag_scaffolds.fa,Chr1,1,14551529,17511000,2959471
BROU-A-10.ragtag_scaffolds.fa,Chr2,1,4614592,7178809,2564217
BROU-A-10.ragtag_scaffolds.fa,Chr3,1,13522501,15674341,2151840
BROU-A-10.ragtag_scaffolds.fa,Chr4,1,4935410,6557327,1621917
BROU-A-10.ragtag_scaffolds.fa,Chr5,1,12602554,14115584,1513030
CAMA-C-2.ragtag_scaffolds.fa,Chr1,1,14829897,17261775,2431878
CAMA-C-2.ragtag_scaffolds.fa,Chr2,1,4366783,6173709,1806926
CAMA-C-2.ragtag_scaffolds.fa,Chr3,1,13887818,16429321,2541503
CAMA-C-2.ragtag_scaffolds.fa,Chr4,1,6411066,8474743,2063677
CAMA-C-2.ragtag_scaffolds.fa,Chr5,1,12212203,15031166,2818963
CAMA-C-9.ragtag_scaffolds.fa,Chr1,1,14833754,17264481,2430727
CAMA-C-9.ragtag_scaffolds.fa,Chr2,1,3873878,5672797,1798919
CAMA-C-9.ragtag_scaffolds.fa,Chr3,1,13887941,16433179,2545238
CAMA-C-9.ragtag_scaffolds.fa,Chr4,1,6248050,8310642,2062592
CAMA-C-9.ragtag_scaffolds.fa,Chr5,1,12209419,15041933,2832514
Cas-0.ragtag_scaffolds.fa,Chr1,1,14478284,16781649,2303365
Cas-0.ragtag_scaffolds.fa,Chr2,1,3963577,7354417,3390840
Cas-0.ragtag_scaffolds.fa,Chr3,1,13464819,17300374,3835555
Cas-0.ragtag_scaffolds.fa,Chr4,1,6057001,7648480,1591479
Cas-0.ragtag_scaffolds.fa,Chr5,1,12147331,14544990,2397659
Cas-6.ragtag_scaffolds.fa,Chr1,1,14438450,17783384,3344934
Cas-6.ragtag_scaffolds.fa,Chr2,1,3978293,7317639,3339346
Cas-6.ragtag_scaffolds.fa,Chr3,1,13251438,16558574,3307136
Cas-6.ragtag_scaffolds.fa,Chr4,1,3576071,4675438,1099367
Cas-6.ragtag_scaffolds.fa,Chr4,2,6822702,8459331,1636629
Cas-6.ragtag_scaffolds.fa,Chr5,1,13446101,16841886,3395785
Cat-0.ragtag_scaffolds.fa,Chr1,1,14253018,18442222,4189204
Cat-0.ragtag_scaffolds.fa,Chr2,1,4278950,6457730,2178780
Cat-0.ragtag_scaffolds.fa,Chr3,1,13499110,16246205,2747095
Cat-0.ragtag_scaffolds.fa,Chr4,1,4783889,9502993,4719104
Cat-0.ragtag_scaffolds.fa,Chr5,1,12766615,15632502,2865887
Col-0.ragtag_scaffolds.fa,Chr1,1,14841148,17216861,2375713
Col-0.ragtag_scaffolds.fa,Chr2,1,4621559,6841935,2220376
Col-0.ragtag_scaffolds.fa,Chr3,1,13596352,15826119,2229767
Col-0.ragtag_scaffolds.fa,Chr4,1,5208114,7982091,2773977
Col-0.ragtag_scaffolds.fa,Chr5,1,12402001,15178500,2776499
Cvi-0.ragtag_scaffolds.fa,Chr1,1,14742408,18486841,3744433
Cvi-0.ragtag_scaffolds.fa,Chr2,1,3540094,6052066,2511972
Cvi-0.ragtag_scaffolds.fa,Chr3,1,13560001,16993252,3433251
Cvi-0.ragtag_scaffolds.fa,Chr4,1,5152097,8294861,3142764
Cvi-0.ragtag_scaffolds.fa,Chr4,2,8989140,9682416,693276
Cvi-0.ragtag_scaffolds.fa,Chr5,1,12640620,17592563,4951943
ddAraThal4.1.primary.fa,Chr1,1,14310575,17105231,2794656
ddAraThal4.1.primary.fa,Chr2,1,3914642,5641910,1727268
ddAraThal4.1.primary.fa,Chr3,1,13390743,17256826,3866083
ddAraThal4.1.primary.fa,Chr4,1,5646614,7659821,2013207
ddAraThal4.1.primary.fa,Chr4,2,8437481,9038952,601471
ddAraThal4.1.primary.fa,Chr5,1,12339051,15627382,3288331
Evs-0.ragtag_scaffolds.fa,Chr1,1,13800363,16101845,2301482
Evs-0.ragtag_scaffolds.fa,Chr2,1,4071647,6601233,2529586
Evs-0.ragtag_scaffolds.fa,Chr3,1,13221001,15457046,2236045
Evs-0.ragtag_scaffolds.fa,Chr4,1,5772594,8531883,2759289
Evs-0.ragtag_scaffolds.fa,Chr5,1,14646289,17835000,3188711
FERR-A-12.ragtag_scaffolds.fa,Chr1,1,14434501,16273500,1838999
FERR-A-12.ragtag_scaffolds.fa,Chr2,1,3867390,6683702,2816312
FERR-A-12.ragtag_scaffolds.fa,Chr3,1,13380073,16581424,3201351
FERR-A-12.ragtag_scaffolds.fa,Chr4,1,5417142,7854415,2437273
FERR-A-12.ragtag_scaffolds.fa,Chr5,1,13599703,16382040,2782337
GAIL-B-11.ragtag_scaffolds.fa,Chr1,1,14366589,16196932,1830343
GAIL-B-11.ragtag_scaffolds.fa,Chr2,1,4972693,7551827,2579134
GAIL-B-11.ragtag_scaffolds.fa,Chr3,1,13644087,16314255,2670168
GAIL-B-11.ragtag_scaffolds.fa,Chr4,1,4452001,6360987,1908986
GAIL-B-11.ragtag_scaffolds.fa,Chr5,1,12451935,15587578,3135643
Hum-2.ragtag_scaffolds.fa,Chr1,1,15008486,17674081,2665595
Hum-2.ragtag_scaffolds.fa,Chr2,1,3797048,6698812,2901764
Hum-2.ragtag_scaffolds.fa,Chr3,1,13218607,16730187,3511580
Hum-2.ragtag_scaffolds.fa,Chr4,1,6424905,10368443,3943538
Hum-2.ragtag_scaffolds.fa,Chr4,2,11154808,11424916,270108
Hum-2.ragtag_scaffolds.fa,Chr5,1,12726048,15535093,2809045
LACR-C-14.ragtag_scaffolds.fa,Chr1,1,14221393,18124089,3902696
LACR-C-14.ragtag_scaffolds.fa,Chr2,1,3652902,6231000,2578098
LACR-C-14.ragtag_scaffolds.fa,Chr3,1,13219689,17176307,3956618
LACR-C-14.ragtag_scaffolds.fa,Chr4,1,5431741,6980358,1548617
LACR-C-14.ragtag_scaffolds.fa,Chr5,1,12363900,14129950,1766050
Ler-0_110x.ragtag_scaffolds.fa,Chr1,1,14538003,16448388,1910385
Ler-0_110x.ragtag_scaffolds.fa,Chr2,1,3889715,5401326,1511611
Ler-0_110x.ragtag_scaffolds.fa,Chr3,1,13992335,16430934,2438599
Ler-0_110x.ragtag_scaffolds.fa,Chr3,2,16662578,17050927,388349
Ler-0_110x.ragtag_scaffolds.fa,Chr4,1,5394546,7765831,2371285
Ler-0_110x.ragtag_scaffolds.fa,Chr5,1,12296069,15662532,3366463
Mdc-14.ragtag_scaffolds.fa,Chr1,1,14355330,18308551,3953221
Mdc-14.ragtag_scaffolds.fa,Chr2,1,3661879,7139184,3477305
Mdc-14.ragtag_scaffolds.fa,Chr3,1,13290082,17100604,3810522
Mdc-14.ragtag_scaffolds.fa,Chr4,1,5302532,7436909,2134377
Mdc-14.ragtag_scaffolds.fa,Chr4,2,8218748,8950498,731750
Mdc-14.ragtag_scaffolds.fa,Chr5,1,12126044,15332907,3206863
Med-0.ragtag_scaffolds.fa,Chr1,1,14661933,17807825,3145892
Med-0.ragtag_scaffolds.fa,Chr2,1,3527323,5600637,2073314
Med-0.ragtag_scaffolds.fa,Chr2,2,6217819,8029349,1811530
Med-0.ragtag_scaffolds.fa,Chr3,1,13534716,16595782,3061066
Med-0.ragtag_scaffolds.fa,Chr4,1,5542722,7927495,2384773
Med-0.ragtag_scaffolds.fa,Chr4,2,8535115,8746500,211385
Med-0.ragtag_scaffolds.fa,Chr5,1,13086309,17133585,4047276
Med-3.ragtag_scaffolds.fa,Chr1,1,14860303,18613475,3753172
Med-3.ragtag_scaffolds.fa,Chr2,1,3740809,5497947,1757138
Med-3.ragtag_scaffolds.fa,Chr3,1,13549938,16162733,2612795
Med-3.ragtag_scaffolds.fa,Chr4,1,7199164,9189000,1989836
Med-3.ragtag_scaffolds.fa,Chr4,2,9970197,10484770,514573
Med-3.ragtag_scaffolds.fa,Chr5,1,12879882,16195348,3315466
MERE-A-13.ragtag_scaffolds.fa,Chr1,1,14579781,18575503,3995722
MERE-A-13.ragtag_scaffolds.fa,Chr2,1,4323255,6403346,2080091
MERE-A-13.ragtag_scaffolds.fa,Chr3,1,13332381,16282644,2950263
MERE-A-13.ragtag_scaffolds.fa,Chr4,1,6025637,8963847,2938210
MERE-A-13.ragtag_scaffolds.fa,Chr5,1,13328778,17525923,4197145
MONTM-B-7.ragtag_scaffolds.fa,Chr1,1,14307116,17433743,3126627
MONTM-B-7.ragtag_scaffolds.fa,Chr2,1,4179158,7332000,3152842
MONTM-B-7.ragtag_scaffolds.fa,Chr3,1,13566894,15971991,2405097
MONTM-B-7.ragtag_scaffolds.fa,Chr4,1,5673513,7301268,1627755
MONTM-B-7.ragtag_scaffolds.fa,Chr4,2,8075842,8361810,285968
MONTM-B-7.ragtag_scaffolds.fa,Chr5,1,12709533,15194586,2485053
MONTM-B-16.ragtag_scaffolds.fa,Chr1,1,14307430,18314885,4007455
MONTM-B-16.ragtag_scaffolds.fa,Chr2,1,3784575,6792366,3007791
MONTM-B-16.ragtag_scaffolds.fa,Chr3,1,13732586,16393239,2660653
MONTM-B-16.ragtag_scaffolds.fa,Chr4,1,5557611,7159373,1601762
MONTM-B-16.ragtag_scaffolds.fa,Chr4,2,7937741,8224498,286757
MONTM-B-16.ragtag_scaffolds.fa,Chr5,1,13485844,16508780,3022936
PREI-A-14.ragtag_scaffolds.fa,Chr1,1,14240386,17579110,3338724
PREI-A-14.ragtag_scaffolds.fa,Chr2,1,3919683,6799252,2879569
PREI-A-14.ragtag_scaffolds.fa,Chr3,1,13639504,16112372,2472868
PREI-A-14.ragtag_scaffolds.fa,Chr4,1,5505074,7074932,1569858
PREI-A-14.ragtag_scaffolds.fa,Chr5,1,12960515,15730233,2769718
SALE-A-10.ragtag_scaffolds.fa,Chr1,1,14842566,18017557,3174991
SALE-A-10.ragtag_scaffolds.fa,Chr2,1,3538016,5232414,1694398
SALE-A-10.ragtag_scaffolds.fa,Chr3,1,13467569,16840467,3372898
SALE-A-10.ragtag_scaffolds.fa,Chr4,1,4745186,6650575,1905389
SALE-A-10.ragtag_scaffolds.fa,Chr5,1,14243457,17178511,2935054
SALE-A-17.ragtag_scaffolds.fa,Chr1,1,14889001,18053104,3164103
SALE-A-17.ragtag_scaffolds.fa,Chr2,1,4080119,5849474,1769355
SALE-A-17.ragtag_scaffolds.fa,Chr3,1,13539468,16909874,3370406
SALE-A-17.ragtag_scaffolds.fa,Chr4,1,4711771,6614312,1902541
SALE-A-17.ragtag_scaffolds.fa,Chr5,1,12461268,15302940,2841672
t2t-col.20210610.fasta,Chr1,1,14841117,17128966,2287849
t2t-col.20210610.fasta,Chr2,1,3826811,6045244,2218433
t2t-col.20210610.fasta,Chr3,1,13597019,15734084,2137065
t2t-col.20210610.fasta,Chr4,1,4203749,6977786,2774037
t2t-col.20210610.fasta,Chr5,1,11797517,14219937,2422420
Tanz-1.patch.scaffold.Chr.fa,Chr1,1,14566620,20618501,6051881
Tanz-1.patch.scaffold.Chr.fa,Chr2,1,3412563,6372728,2960165
Tanz-1.patch.scaffold.Chr.fa,Chr3,1,12761364,14189044,1427680
Tanz-1.patch.scaffold.Chr.fa,Chr3,2,14863501,17369293,2505792
Tanz-1.patch.scaffold.Chr.fa,Chr4,1,5178819,6892744,1713925
Tanz-1.patch.scaffold.Chr.fa,Chr4,2,7671948,8001000,329052
Tanz-1.patch.scaffold.Chr.fa,Chr5,1,11182853,13066962,1884109
Tanz-1.patch.scaffold.Chr.fa,Chr5,2,13354975,13998284,643309
Tanz-1.patch.scaffold.Chr.fa,Chr5,3,14553551,18517499,3963948
ANGE-B-10.ragtag_scaffolds.fa,Chr1,1,14248547,16858500,2609953
ANGE-B-10.ragtag_scaffolds.fa,Chr2,1,3876105,7106970,3230865
ANGE-B-10.ragtag_scaffolds.fa,Chr3,1,13230033,16220529,2990496
ANGE-B-10.ragtag_scaffolds.fa,Chr4,1,5124099,8030516,2906417
ANGE-B-10.ragtag_scaffolds.fa,Chr5,1,12302344,15411920,3109576
FERR-A-8.ragtag_scaffolds.fa,Chr1,1,14534083,17297606,2763523
FERR-A-8.ragtag_scaffolds.fa,Chr2,1,3789306,6937279,3147973
FERR-A-8.ragtag_scaffolds.fa,Chr3,1,13345614,15867983,2522369
FERR-A-8.ragtag_scaffolds.fa,Chr3,2,16103394,16574825,471431
FERR-A-8.ragtag_scaffolds.fa,Chr4,1,5899549,8815236,2915687
FERR-A-8.ragtag_scaffolds.fa,Chr5,1,12354575,16893233,4538658
Hom-0.ragtag_scaffolds.fa,Chr1,1,14543023,19509935,4966912
Hom-0.ragtag_scaffolds.fa,Chr2,1,4729602,7634896,2905294
Hom-0.ragtag_scaffolds.fa,Chr3,1,13719946,16790270,3070324
Hom-0.ragtag_scaffolds.fa,Chr4,1,5901753,8964082,3062329
Hom-0.ragtag_scaffolds.fa,Chr5,1,13183571,15426000,2242429
Hom-4.ragtag_scaffolds.fa,Chr1,1,14264209,17976828,3712619
Hom-4.ragtag_scaffolds.fa,Chr2,1,3606473,5295215,1688742
Hom-4.ragtag_scaffolds.fa,Chr3,1,13247164,16896456,3649292
Hom-4.ragtag_scaffolds.fa,Chr4,1,5523375,8153887,2630512
Hom-4.ragtag_scaffolds.fa,Chr4,2,8874005,9465658,591653
Hom-4.ragtag_scaffolds.fa,Chr5,1,13146146,16341749,3195603
Mos-5.ragtag_scaffolds.fa,Chr1,1,14439416,16558254,2118838
Mos-5.ragtag_scaffolds.fa,Chr2,1,3888220,6217473,2329253
Mos-5.ragtag_scaffolds.fa,Chr3,1,13590331,15862048,2271717
Mos-5.ragtag_scaffolds.fa,Chr4,1,5922001,8095891,2173890
Mos-5.ragtag_scaffolds.fa,Chr4,2,8871585,9389950,518365
Mos-5.ragtag_scaffolds.fa,Chr5,1,14564255,17715000,3150745
Mos-9.ragtag_scaffolds.fa,Chr1,1,14683672,19070439,4386767
Mos-9.ragtag_scaffolds.fa,Chr2,1,4493558,5033019,539461
Mos-9.ragtag_scaffolds.fa,Chr2,2,5653614,8071276,2417662
Mos-9.ragtag_scaffolds.fa,Chr3,1,13716239,16337957,2621718
Mos-9.ragtag_scaffolds.fa,Chr4,1,4888574,8324527,3435953
Mos-9.ragtag_scaffolds.fa,Chr4,2,9041969,9508291,466322
Mos-9.ragtag_scaffolds.fa,Chr5,1,13490234,17842398,4352164
Hum-4.ragtag_scaffolds.fa,Chr1,1,14710522,17298545,2588023
Hum-4.ragtag_scaffolds.fa,Chr2,1,3672062,6498933,2826871
Hum-4.ragtag_scaffolds.fa,Chr3,1,13995923,15732203,1736280
Hum-4.ragtag_scaffolds.fa,Chr4,1,4228696,7147159,2918463
Hum-4.ragtag_scaffolds.fa,Chr5,1,13264612,15225506,1960894
Evs-12.ragtag_scaffolds.fa,Chr1,1,14511569,17689852,3178283
Evs-12.ragtag_scaffolds.fa,Chr2,1,3651930,6741109,3089179
Evs-12.ragtag_scaffolds.fa,Chr3,1,13686001,14506481,820480
Evs-12.ragtag_scaffolds.fa,Chr3,2,14892089,15558968,666879
Evs-12.ragtag_scaffolds.fa,Chr4,1,5449502,8218857,2769355
Evs-12.ragtag_scaffolds.fa,Chr5,1,12509533,16090429,3580896
Lor-16.ragtag_scaffolds.fa,Chr1,1,14568418,16659080,2090662
Lor-16.ragtag_scaffolds.fa,Chr2,1,4633738,6418527,1784789
Lor-16.ragtag_scaffolds.fa,Chr3,1,13282601,16175902,2893301
Lor-16.ragtag_scaffolds.fa,Chr4,1,5671684,9546196,3874512
Lor-16.ragtag_scaffolds.fa,Chr5,1,13309955,17900850,4590895
Met-6.ragtag_scaffolds.fa,Chr1,1,14512542,16331976,1819434
Met-6.ragtag_scaffolds.fa,Chr2,1,4268289,6656938,2388649
Met-6.ragtag_scaffolds.fa,Chr3,1,13586179,16882428,3296249
Met-6.ragtag_scaffolds.fa,Chr4,1,5793080,10039625,4246545
Met-6.ragtag_scaffolds.fa,Chr4,2,10734236,11357991,623755
Met-6.ragtag_scaffolds.fa,Chr5,1,13714851,17321966,3607115
San-9.ragtag_scaffolds.fa,Chr1,1,14746858,17496989,2750131
San-9.ragtag_scaffolds.fa,Chr2,1,4086364,7463999,3377635
San-9.ragtag_scaffolds.fa,Chr3,1,13405938,15447087,2041149
San-9.ragtag_scaffolds.fa,Chr4,1,4569513,8711825,4142312
San-9.ragtag_scaffolds.fa,Chr4,2,9490244,9702902,212658
San-9.ragtag_scaffolds.fa,Chr5,1,13831670,17448000,3616330
Sln-22.ragtag_scaffolds.fa,Chr1,1,13792728,16360496,2567768
Sln-22.ragtag_scaffolds.fa,Chr2,1,3732393,7370074,3637681
Sln-22.ragtag_scaffolds.fa,Chr3,1,12314046,12943143,629097
Sln-22.ragtag_scaffolds.fa,Chr3,2,14490014,16493236,2003222
Sln-22.ragtag_scaffolds.fa,Chr4,1,5715115,9201848,3486733
Sln-22.ragtag_scaffolds.fa,Chr5,1,13430382,17323363,3892981